11
40
[ H       H        H         H         ]
[                    X                I]
[  X        V                V         ]
[       X                              ]
[ V                V     X             ]
[      V      X                   <   I]
[  X                                   ]
[     X    <           <      X        ]
[                X                     ]
[ @    X                 <          < I]
[            <    X            X       ]