9
28
[                       V  ]
[                          ]
[I                         ]
[                          ]
[                          ]
[                          ]
[                   @      ]
[                          ]
[   H                      ]