8
15
[V V V V V V V]
[ V V V V V V ]
[             ]
[             ]
[             ]
[             ]
[             ]
[      @      ]