8
52
[              X         X      X            X    ]
[  @     X       X   X     X           X   X    X ]
[           X     X   X          X      X         ]
[     X         X          X       X       X      ]
[      X    X    X     X        X              X  ]
[  X      X           X       X        X   X      ]
[      X        X   X     X       X           X   ]
[           X        X      X        X     X      ]