8
31
[                          X  ]
[       X                     ]
[                             ]
[                             ]
[              @              ]
[                             ]
[                             ]
[ X                           ]