18
35
[XXXXXXXXXXXXXXXXXXXXXXXXXXXXXXXXX]
[XXXXXXXXXXXXXXXXXXXXXXXXXXXXXXXXX]
[XX                             XX]
[XX                             XX]
[XX                             XX]
[XX                             XX]
[XX                             XX]
[XX                             XX]
[XX                             XX]
[XX             @               XX]
[XX                             XX]
[XX                             XX]
[XX                             XX]
[XX                             XX]
[XX                             XX]
[XX                             XX]
[XXXXXXXXXXXXXXXXXXXXXXXXXXXXXXXXX]
[XXXXXXXXXXXXXXXXXXXXXXXXXXXXXXXXX]