7
31
[                             ]
[       @                     ]
[                           X ]
[                             ]
[                             ]
[  >                     X    ]
[                             ]