9
33
[XX                           V]
[X                             ]
[              @               ]
[                              ]
[                              ]
[                              ]
[                              ]
[                              ]
[H                             ]