8
26
[      H          H      ]
[                        ]
[                        ]
[                        ]
[                        ]
[                        ]
[                        ]
[           @            ]