9
9
[@      ]
[       ]
[       ]
[       ]
[       ]
[       ]
[      I]
[      I]
[ H  H  ]