12
38
[ HHHHHHHHHHHHHHHHHHHHHHHHHHHHHHHHHH ]
[I                                  I]
[I                                  I]
[I                                  I]
[I                                  I]
[I                                  I]
[I               @                  I]
[I                                  I]
[I                                  I]
[I                                  I]
[I                                  I]
[ HHHHHHHHHHHHHHHHHHHHHHHHHHHHHHHHHH ]