5
20
[@ X<  V  X    X< I]
[<^^< ^ X   <      ]
[VX>   X  X        ]
[X  ^  <           ]
[XXX              I]