8
30
[               X           H]
[    V                       ]
[         V         X        ]
[                            ]
[                            ]
[              <             ]
[  @                 X       ]
[                 <          ]